2500
1000
384
112
7
108,184,40,55,0,71,1,1
108,382,40,55,0,71,-1,1
970,368,50,50,45,0,1,1
980,280,50,50,45,0,-1,1
970,192,50,50,45,0,1,1
1769,824,348,70,0,81,1,1
1769,1061,348,70,0,81,-1,1