-1
2500
1000
444
112
7
108,244,40,55,0,60,1,1
108,422,40,55,0,60,-1,1
970,368,50,20,45,0,1,1
980,280,50,20,45,0,-1,1
970,192,50,20,45,0,1,1
1769,824,348,70,0,81,1,1
1769,1061,348,70,0,81,-1,1
