2500
1000
384
112
7
108,184,40,55,0,71,1,3
108,382,40,55,0,71,-1,3
932,368,50,50,56,0,1,3
1020,280,50,50,56,0,-1,3
932,192,50,50,56,0,1,3
1769,824,348,70,0,81,1,3
1769,1061,348,70,0,81,-1,3